  0,  0,  0,  0,  0,  0,  0,  0,  0,  0,  0,  0,  0,  0,  0,  0,  0,  0,  0,  0,  0,  0,  0,  0,  0, 23, 24, 24
  0, 18, 37, 17, 20,  0,  0,  0,  0,  0,  0,  0,  0,  7,  8,  8,  9,  0,  0,  0, 32, 31,  0, 31,  0, 23, 24, 24
  0, 34, 16, 33,  0, 62, 63, 48, 49, 62, 63,  0,  0, 23, 24, 24, 25,  0, 18, 37, 17, 47,110, 47,  0, 23, 24, 24
  0, 34, 16, 33,  0, 78, 79, 64, 65, 78, 79,  0,  0, 23, 24, 24, 25,  0, 34,  3,  1, 31,110, 31,  0, 23, 24, 24
 21, 34, 16, 33,  0, 94, 95,  0,  0, 94, 95, 15,  0, 23, 24, 24, 25,  0, 34, 33,  0, 47,  0, 47,  0, 23, 24, 24
  0, 34, 16, 33,  0,  0,  0,  0,  0,  0,  0,  0,  0, 39, 40, 40, 41,  0, 34, 33,  0,  0, 21,  0,  0, 23, 24, 24
  0, 34, 16, 33, 32,  0,  0,  0,  0,  0,  0,  0,  0,  0,  0,  0,  0,  0, 34, 33,  0,  0,  0,  0, 32, 23, 24, 24
  0, 34, 16, 35, 36, 36, 36, 36, 36, 36, 36, 36, 36, 36, 36, 36, 36, 36, 38, 35, 36, 36, 36, 36, 17, 23, 24, 24
  0, 34, 16, 16, 16, 16, 16, 16, 16, 16, 16, 16, 16, 16, 16, 16, 16, 16, 16, 16, 16, 16, 16, 16, 33, 23, 24, 24
  0, 34, 16,  3,  4,  4,  4,  4,  4,  4,  4,  4,  4,  4,  4,  4,  4,  4,  4,  4,  4,  4,  4,  4,  1, 23, 24, 24
 20, 34, 16, 33,  0,  0,  0,  0,  0,  0,  0,  0,  0,  0,  0,  0, 10, 11, 12, 11, 12, 11, 12, 13, 14, 23, 24, 24
  0, 34, 16, 33,  0, 50, 51, 52, 53,  0, 54, 55, 56, 57, 58,  0, 26, 27, 28, 27, 28, 27, 28, 29, 30, 23, 24, 24
  0, 34, 16, 33,  0, 66, 67, 68, 69, 15, 70, 71, 72, 73, 74,  0, 42, 43, 44, 43, 44, 43, 44, 45, 46, 23, 24, 24
  0, 34, 16, 33,  0, 82, 83, 84, 85,  0, 86, 87, 88, 89, 90,  0,  0,  0,  0,  0,  0, 15,  0,  0,  0, 23, 24, 24
  0, 34, 16, 33, 32, 98, 99,100,101,111,102,103,104,105,106,  0,  0, 15,  0, 20,  0,  0,  0,  0,  0, 39, 40, 40
  0, 34, 16, 35, 36, 36, 36, 36, 36, 36, 36, 36, 36, 36, 36, 36, 36, 36, 36, 36, 36, 36, 36, 36, 36, 36, 36, 36
  0, 34, 16,  3,  4,  4,  4,  4,  4,  4,  4,  4,  4,  4,  4,  4,  4,  4,  4,  4,  4,  4,  4,  4,  4,  4,  4,  4
  0, 34, 16, 33,  0,  0,  0,  0, 80, 81,  0,  0,  0,  0,  0,  0,  0,  0,  0,  0,  0,  0, 15,  0,  0, 62, 63,  0
  0, 34, 16, 33,  0,  0,  0,  0, 96, 97,  0, 48, 49, 15,  0,  0,  0,  0, 80, 81,  0,  0,  0,  0,  0, 78, 79,  0
  0, 34, 16, 33,  0,  0,  0,  0,  0,  0,  0, 64, 65,  0,  0,  0,  0,  0, 96, 97,  0,  0,  0,  0,  0, 94, 95,  0
  0, 34, 16, 33,  0, 59, 60, 61,  0, 59, 60, 61,  0, 59, 60, 61,  0, 59, 60, 61,  0, 59, 60, 61,  0, 59, 60, 61
  0, 34, 16, 33,  0, 75, 76, 77,  0, 75, 76, 77,  0, 75, 76, 77,  0, 75, 76, 77,  0, 75, 76, 77,  0, 75, 76, 77
  0, 34, 16, 33,  0, 91, 92, 93,  0, 91, 92, 93,  0, 91, 92, 93,  0, 91, 92, 93,  0, 91, 92, 93,  0, 91, 92, 93
  0, 34, 16, 33, 32,107,108,109,111,107,108,109,  0,107,108,109,111,107,108,109,  0,107,108,109,111,107,108,109
  0, 34, 16, 35, 36, 36, 36, 36, 36, 36, 36, 36, 36, 36, 36, 36, 36, 36, 36, 36, 36, 36, 36, 36, 36, 36, 36, 36
  0, 34, 16,  3,  4,  4,  4,  4,  4,  4,  4,  4,  4,  4,  4,  4,  4,  4,  4,  4,  4,  4,  4,  4,  4,  4,  4,  4
  0, 34, 16, 33,  0,  0,  0,  0,  0,  0,  0,  0,  0,  0,  0, 20,  0,  0,  0, 21,  0,  0,  0,  0,  0,  0,  0,  0
